[settings]
name:Level 1
tilewidth:32
tileheight:32
[tile_aliases]
1:BlockRed
2:BlockBlue
3:Ground1
4:DoorRed
5:DoorBlue
6:Ground2
[map]
1111111111111
1333333333331
1333333333331
1333111113331
1333100013331
1333100013331
1333111113331
1333333333331
1333333333331
1111111111111
[objects]
0000000000000
0000000000000
0010000000000
0000000000000
0000000000000
0000000000000
0000000000000
0000000000200
0000000000000
0000000000000
